        ####################
        #....*...#...G.....#
        #.####.#.#.#.####..#
        #.#  #.#.#.#.#  #..#
        #.#  #.#.#.#.#  #..#
        #.####.#.#.#.####..#
        #.................*#
        #.###...#####.###..#
        #..G...............#
        ###.####.#.####.####
        #........P.........#
        #.####.###.####.#..#
        #.#.............#..#
        #.#.###########.#..#
        #.#..........*..#..#
        #.#####.###.#####..#
        #..........G...... #
        ####################