        #####################
        #.....*.....G.......#
        #..#.####...####.#..#
        #..#.#  #...#  #.#..# 
        #..#.#  #...#  #.#..#
        #..#.####...####.#..#
        #...................#
        ###...####.####...###
        #........G..........#
        #...####.....####...#
        #...............*...#
        #..#####.###.#####..#
        #.........P.........#
        #####################