        ####################
        #....G...#....G....#
        #.####.#.#.####.#..#
        #.#  #.#.#.#  #.#..#
        #.#  #.#.#.#  #.#..#
        #.####.#.#.####.#..#
        #.................#
        #.###.#.#####.###..#
        #..G..#...#....G...#
        ###.####.#.####.####
        #........P.........#
        #.####.###.####.#..#
        #.#.............#..#
        #.#.###########.#..#
        #.#.............#..#
        #.#####.###.#####..#
        #.........G....... #
        ####################