        ####################
        #........#...G.....#
        #.####.#.#.#.####..#
        #.#  #.#.#.#.#  #..#
        #.#  #.#.#.#.#  #..#
        #.####.#.#.#.####..#
        #..................#
        #.###...#####.###..#
        #..G...............#
        ###.####.#.####.####
        #........P.........#
        #.####.###.####.#..#
        #.#.............#..#
        #.#.###########.#..#
        #.#.............#..#
        #.#####.###.#####..#
        #..........G...... #
        ####################