        #####################
        #...........G.......#
        #..#.####...####.#..#
        #..#.#  #...#  #.#..# 
        #..#.#  #...#  #.#..#
        #..#.####...####.#..#
        #...................#
        ###...####.####...###
        #........G..........#
        #...####.....####...#
        #...................#
        #..#####.###.#####..#
        #.........P.........#
        #####################